SSSSSSSSSSSSSSSSS
SEEEEEEWWEWEEEEWS
SESESESESESESWSWS
SEEEWEEEEEWWWEEWS
SESESESESESWSESES
SEEEEEEEEEEWEWWES
SESESESESESESESES
SWEEWEEEEEEWEEWES
SESESESESWSESESES
SWEEEEWWEEWEEEWES
SESWSESESESESESES
SEEEEEEEEEEEWEEES
SSSSSSSSSSSSSSSSS
